..##.....T
#.##..###.
#.###E###E
#...H.###.
###T#####G
