S.##.....T
#.##..###.
#.###E###E
#.....###.
###T#####G
